2 2 2 2 2 2 2 2 2 2 8 4 4 4 4 4 4 4 4 4 4 4 4 4 4 4 4 4 4 4 4 4 4 4 4 4 4 4 4 4 4 4 4 4 4 4 4 4 4 4
2 2 2 2 2 2 2 2 2 2 8 4 4 4 4 4 4 4 4 4 4 4 4 4 4 4 4 4 4 4 4 4 4 4 4 4 4 4 4 4 4 4 4 4 4 4 4 4 4 4
2 2 2 2 2 2 2 2 2 2 8 4 4 4 0 0 0 0 0 0 4 4 4 4 4 4 4 4 4 4 4 4 4 4 4 4 4 4 4 4 4 4 4 4 4 4 4 4 4 4
2 2 2 2 2 2 2 2 2 2 8 4 4 4 0 0 0 0 0 0 4 4 4 4 4 4 4 4 4 4 4 4 4 4 4 4 4 4 4 4 4 4 4 4 4 4 4 4 4 4
2 2 2 2 2 2 2 2 2 2 8 4 4 4 4 4 4 4 0 0 4 4 4 22 3 21 4 4 4 4 4 4 4 4 4 4 4 5 4 4 4 4 4 4 4 4 4 4 4 4
1 1 2 2 2 2 2 2 2 2 8 4 4 4 4 4 4 4 0 0 4 4 4 22 3 21 4 4 4 4 4 4 4 4 4 4 4 5 4 4 4 4 4 4 4 4 4 4 4 4
2 2 1 2 1 1 2 2 2 2 8 4 4 4 0 0 0 0 0 0 0 0 4 22 3 21 4 4 4 4 4 4 4 4 4 4 4 5 4 4 4 4 4 4 4 4 4 4 4 4
2 2 2 1 2 2 1 2 2 2 8 4 4 4 4 4 4 0 0 4 4 0 4 22 3 21 4 4 4 4 4 4 4 4 4 4 4 5 4 4 0 0 4 4 4 4 4 4 4 4
1 2 2 2 1 2 2 2 2 2 8 4 4 4 4 4 0 0 0 4 4 0 4 22 3 21 4 4 4 4 4 4 4 4 4 4 4 5 4 4 0 0 4 4 4 4 4 4 4 4
2 2 1 2 2 2 2 2 2 2 2 8 0 15 17 17 17 17 17 17 17 17 17 3 3 3 17 17 17 17 17 17 17 17 17 17 17 17 17 17 17 17 19 4 4 4 4 4 4 4
2 2 1 2 2 2 2 2 2 2 2 8 0 22 3 3 3 3 3 3 3 3 3 3 3 3 3 3 3 3 3 3 3 3 3 3 3 3 3 3 3 3 21 4 4 4 4 4 4 4
2 2 2 1 2 2 2 2 2 2 2 8 0 16 18 18 18 18 18 18 18 18 18 3 3 3 18 18 18 18 18 18 18 18 18 18 18 18 18 18 18 18 20 4 4 4 4 4 4 4 4
2 2 2 2 2 2 2 2 2 2 2 8 0 0 0 0 0 4 4 4 4 4 0 22 3 21 0 4 4 4 4 0 0 0 0 4 4 4 4 0 0 0 0 4 4 4 4 4 4 4
1 2 2 2 2 1 2 2 2 2 2 8 0 0 0 0 0 0 0 0 0 4 4 22 3 21 4 4 4 4 4 4 4 4 4 0 0 4 4 0 0 4 4 4 4 4 4 4 4 4
2 1 2 2 2 2 1 2 2 12 13 9 0 0 0 0 0 0 0 4 0 4 4 22 3 21 4 4 0 0 4 4 0 0 0 0 0 0 4 4 0 0 0 0 4 4 4 4 4 4 4
2 2 1 2 2 1 2 1 2 8 0 0 0 0 0 0 0 0 0 4 0 0 4 22 3 21 0 0 0 0 0 0 0 0 0 0 0 0 0 0 0 0 0 4 4 4 4 4 4 4
2 2 2 1 1 2 2 2 1 8 0 0 0 0 0 0 0 0 0 4 4 4 4 22 3 21 0 0 0 0 0 0 0 0 0 0 0 0 0 0 0 0 0 4 4 4 4 4 4 4
2 2 2 2 2 2 2 2 2 14 10 10 10 10 10 10 10 10 10 11 0 0 4 22 3 21 0 0 0 0 4 4 4 4 0 0 0 0 0 0 0 0 0 4 4 4 4 4 4 4
2 1 1 1 2 1 1 2 1 2 2 2 2 2 2 2 2 2 2 8 0 0 4 22 3 21 0 0 0 0 4 4 4 4 0 0 0 0 0 0 0 4 4 4 4 4 4 4 4 4
1 2 2 2 1 2 2 1 2 2 2 2 2 2 2 2 2 2 2 8 0 0 4 22 3 21 0 4 4 4 4 4 4 4 4 4 4 4 4 4 4 4 4 4 4 4 4 4 4 4
2 2 2 2 2 2 2 2 2 2 2 2 2 2 2 2 2 2 2 8 0 0 4 22 3 21 0 4 4 4 4 4 4 4 4 4 4 4 4 4 4 4 4 4 4 4 4 4 4 4
2 2 2 2 2 2 2 2 2 2 2 2 2 2 2 2 2 2 2 8 0 0 4 22 3 21 0 4 4 4 4 4 4 4 4 4 4 4 4 4 4 4 4 4 4 4 4 4 4 4
2 2 2 2 2 2 2 2 2 2 2 2 2 2 2 2 2 2 2 8 0 0 0 22 3 21 4 4 4 4 4 4 4 4 4 4 4 4 4 4 4 4 4 4 4 4 4 4 4 4
2 2 2 2 2 2 2 2 2 2 2 2 2 2 2 2 2 2 2 8 0 0 0 22 3 21 0 0 4 4 4 4 4 4 4 4 4 4 4 4 4 4 4 4 4 4 4 4 4 4
2 2 2 2 2 2 2 2 2 2 2 2 2 2 2 2 2 2 2 8 0 0 4 22 3 21 0 0 0 0 0 0 0 0 0 0 0 0 0 0 0 0 0 0 0 4 4 4 4 4
2 2 2 2 2 2 2 2 2 2 2 2 2 2 2 2 2 2 2 8 0 0 4 22 3 21 0 0 0 0 0 0 0 0 0 0 0 0 0 0 0 0 0 0 0 0 4 4 4 4
2 2 2 2 2 2 2 2 2 2 2 2 2 2 2 2 2 2 2 8 0 0 4 22 3 3 17 17 17 17 17 17 17 17 17 17 17 17 17 17 17 17 17 17 17 0 4 4 4 4
2 2 2 2 2 2 2 2 2 2 2 2 2 2 2 2 2 12 13 9 0 0 4 22 3 3 3 3 3 3 3 3 3 3 3 3 3 3 3 3 3 3 3 3 3 0 4 4 4 4
2 2 2 2 2 2 2 2 2 2 2 2 2 2 2 2 2 8 0 0 0 0 4 22 3 3 18 18 18 18 18 18 18 18 18 18 18 18 18 18 18 18 18 3 3 0 4 4 4 4
2 2 2 2 2 2 2 2 2 2 2 2 2 2 2 2 2 8 0 0 0 0 4 22 3 21 0 0 0 0 0 0 0 0 0 0 0 0 0 0 0 0 0 3 3 0 4 4 4 4
2 2 2 2 2 2 2 2 2 2 2 2 2 2 2 2 2 8 0 0 0 0 4 22 3 21 0 4 4 4 4 4 4 4 4 4 4 4 4 4 4 4 0 3 3 0 4 4 4 4
2 2 2 2 2 2 2 2 2 2 2 2 2 2 2 2 2 8 0 0 0 0 4 22 3 21 0 0 0 0 0 0 0 0 0 0 0 0 0 0 0 4 0 3 3 0 4 4 4 4
2 2 2 2 2 2 2 2 2 2 2 2 2 2 2 2 2 8 0 0 0 0 0 22 3 21 0 0 0 0 0 0 0 0 0 0 0 0 0 0 0 4 0 3 3 0 4 4 4 4
2 2 2 2 2 2 2 2 2 2 2 2 2 2 2 2 2 8 0 0 0 0 4 22 3 21 0 4 4 4 4 4 4 4 4 4 4 4 4 4 4 4 0 3 3 0 4 4 4 4
2 2 2 2 2 2 2 2 2 2 2 2 2 2 2 2 2 8 0 0 0 0 0 22 3 21 0 0 0 0 0 0 0 0 0 0 0 0 0 0 0 0 0 3 3 0 0 0 0 4
2 2 2 1 2 2 2 2 2 2 2 2 2 2 2 2 2 14 10 6 6 6 6 6 6 6 6 6 6 6 6 6 6 6 6 6 6 6 6 6 6 6 6 3 3 0 0 0 0 4
2 2 2 2 2 2 2 2 2 2 2 2 2 2 2 1 2 2 2 6 6 6 6 6 6 6 6 6 6 6 6 6 6 6 6 6 6 6 6 6 6 6 6 6 6 4 4 0 0 4
2 2 2 2 2 2 2 1 2 2 2 2 2 2 2 2 2 2 6 6 7 6 6 6 6 6 6 7 6 6 6 6 6 6 7 6 6 6 6 7 6 6 6 6 6 4 4 0 0 4
2 2 2 2 2 2 2 2 1 2 2 2 2 2 2 2 2 2 2 6 6 6 6 6 6 6 6 6 6 6 6 6 6 6 6 6 6 6 6 6 6 6 6 6 6 4 4 0 0 4
2 2 2 2 2 2 2 2 2 2 2 2 2 2 2 1 2 2 2 6 6 6 6 6 6 6 6 6 6 6 6 6 6 6 6 6 6 6 6 6 6 6 6 6 6 4 4 4 4 4
2 2 2 2 2 2 2 2 2 2 2 2 2 2 2 2 2 2 2 6 6 6 6 6 6 6 6 6 6 6 7 6 6 6 6 6 6 6 6 6 6 6 6 6 6 4 4 4 4 4
2 2 2 2 2 2 2 2 2 2 2 2 2 2 2 2 2 2 2 6 6 6 6 6 6 6 6 6 6 6 6 6 6 6 6 6 6 6 6 6 6 6 6 6 6 4 4 4 4 4
2 2 2 2 2 2 2 2 2 1 2 2 2 2 2 2 2 6 6 6 6 6 6 6 6 6 7 6 6 6 6 6 6 6 6 6 6 6 6 6 6 6 6 6 6 4 4 4 4 4
2 2 2 2 2 2 2 2 2 2 2 2 2 2 2 2 2 2 6 6 6 7 6 6 6 6 6 6 6 6 6 6 6 6 6 6 6 7 6 6 6 6 6 6 6 4 4 6 6 4
2 2 2 2 2 2 2 2 2 2 1 2 2 2 2 2 2 2 2 6 6 6 6 6 6 6 6 6 6 6 6 6 7 6 6 6 6 6 6 6 6 6 6 6 6 4 4 6 6 4
2 2 2 2 2 2 2 2 2 2 2 2 2 2 2 2 2 2 2 2 2 2 2 6 6 6 6 6 6 6 6 6 6 6 6 6 6 6 6 6 6 6 6 6 6 4 4 6 6 4
2 2 2 2 2 2 2 2 2 2 2 1 2 2 2 2 2 2 2 2 2 2 2 2 2 2 2 2 2 2 2 2 2 2 2 2 2 2 2 2 2 2 2 2 7 4 4 6 6 4
2 2 2 2 2 2 2 2 2 2 2 2 1 2 2 2 2 2 2 2 2 2 2 2 2 2 2 2 2 2 2 2 2 2 2 2 2 2 2 2 2 2 2 2 6 6 6 6 6 2
2 2 2 2 2 2 2 2 2 2 2 2 2 1 1 2 1 1 2 1 1 2 1 1 2 1 1 2 1 1 2 1 1 2 1 1 2 2 1 1 2 2 1 2 2 2 2 2 2 1
2 2 2 2 2 2 2 2 2 2 2 2 2 2 2 1 2 2 1 2 2 1 2 2 1 2 2 1 2 2 1 2 2 1 2 2 1 1 2 2 1 1 2 1 1 1 1 1 1 2